XXXXXXXX-X
X----C---X
XXO----C-XX
X----O--CX
X-CC---O-X
X-XXXXXXXX