XXXXXXXX-X
X----C---X
XXO----C-X
X----O--CX
X-CC---O-X
X-XXXXXXXX